1111111111111111111111
1C1000000000111C0000C1
101C100001111111111011
1000G00P00000000G01011
10000010111110100C1011
1111101010101010001011
10001C1011111010001011
1C1C101011111010G01011
1110111010001010001011
1C00C00C101010000000E1
1111111111111111111111