11111111
100p1001
10cc00e1
11111111